NO ./assets/arbitroooooooo.xpm
SO ./assets/er_pupone.xpm
WE ./assets/spallettone.xpm
EA ./assets/idolo.xpm

F 50,50,50
C 219,36,158

1111111111111111111111111111111111111111111111111111
1111111111111110000000000000011111111111111111111111
1111111111111111000000000000000011111111111111111111
1111111111111111000000000000000011111111111111111111
11111111111111110000000F0000000001111111111111111111
1111111111111111000000000000000001100000001111111111
1111111111111111000000000000000001100000001111111111
1111111111111111100000000000F00000000000001111111111
11111111111111111000Z0000000000000000000001111111111
111111111111111110000000000000000000Z000001111111111
1111111111111111110000000000000000000000001111111111
1111111111111111111110000000000000000000001111111111
1111111111111111111110001111000000000000001111111111
1111111111111111111110001111111100000000001111111111
1111111111111111111110001111111100000000001111111111
1111111111111110000000001111111100000000001111111111
1111111111111110000000001111111100000000001111111111
11111111111111100F0000001111111111110000001111111111
1111111111111110000011111111111111111111111111111111
1111111111111110000011111111111111111111111111111111
1111111111111110000011111111111111111111111111111111
1111111111111110000000000111111111111111111111111111
1111111111111110000000000001111111111111111111111111
1111111111111110000Z00000001111111111111111111111111
1111111111111110000000000001111111111111111111111111
1111111111111110000N10000001111111111111111111111111
1111111111111111111111111111111111111111111111111111
