NO ./assets/arbitroooooooo.xpm
SO ./assets/er_pupone.xpm
WE ./assets/spallettone.xpm
EA ./assets/idolo.xpm

F 220,100,0
C 225,30,0

1111111111
1000100001
1000100001
1100000001
1000000001
1000000001
1000N00001
1000000001
1000000001
1111111111
