NO ./assets/Napoli1.xpm
SO ./assets/Napoli2.xpm
WE ./assets/Napoli3.xpm
EA ./assets/idolo.xpm

F 66,132,245
C 54,20,7

1111111111
1200100001  1
100010000111
1121100001
1N000000011111
11111011100001
	1000111101
 10 1000000001
    1000000001
	1111111111
