NO ./assets/arbitroooooooo.xpm
SO ./assets/er_pupone.xpm
WE ./assets/spallettone.xpm
EA ./assets/idolo.xpm

F 66,132,245
C 54,20,7

1111111111
10001000201  1
100010000111
1101100001
10000001011111
1111100D100001
	1001111101
 10 100N000001
    1002000001
	1111111111
