NO ./srcs/sprites/test/purplestone.xpm
SO ./srcs/sprites/test/redbrick.xpm
WE ./srcs/sprites/test/mossy.xpm
EA ./srcs/sprites/test/bluestone.xpm

F 66,132,245
C 54,20,7

1111111111
1000100001  1
100010000111
1101100001
1N000000011111
11111011100001
	1000111101
 10 1000000001
    1000000001
	1111111111
