NO ./srcs/sprites/test/purplestone.xpm
SO ./srcs/sprites/test/redbrick.xpm
WE ./srcs/sprites/test/mossy.xpm
EA ./srcs/sprites/test/bluestone.xpm

F 220,100,0
C 225,30,0

1111111111
1000100001  1
100010000111
1101100001
1N000000011111
11111011100001
	1000111101
 1  1000000001
	1000000001
	1111111111
