NO ./assets/arbitroooooooo.xpm
SO ./assets/er_pupone.xpm
WE ./assets/spallettone.xpm
EA ./assets/idolo.xpm

F 66,132,245
C 54,20,7

1111111111
10001000001  1
100010000111
1101100001
1E200000011111
11111011100001
	1000111101
 10 1000000001
    1000000001
	1111111111
